00,00,00,00,01,00,00,00,00
00,01,01,01,01,01,01,01,00
00,01,01,01,01,01,01,01,00
00,01,01,01,01,01,01,01,00
01,01,01,01,01,01,01,01,00
00,01,01,01,01,01,01,01,00
00,01,01,01,01,01,01,01,00
00,01,01,01,01,01,01,01,00
00,00,00,00,01,00,00,00,00

1,1,1,1,0,1,1,1,1
1,0,0,0,0,0,0,0,1
1,0,0,0,0,0,0,0,1
1,0,0,0,0,0,0,0,1
0,0,0,0,0,0,0,0,1
1,0,0,0,0,0,0,0,1
1,0,0,0,0,0,0,0,1
1,0,0,0,0,0,0,0,1
1,1,1,1,0,1,1,1,1
