tileswide 20
tileshigh 25
tilewidth 32
tileheight 32

layer 0
21,21,21,21,21,21,21,21,21,21,21,21,21,21,21,21,21,21,21,21,
21,21,17,13,13,13,13,13,13,18,21,21,21,17,13,13,13,13,13,18,
21,21,11,8,8,8,8,8,8,22,21,21,21,11,8,8,8,8,8,22,
21,21,11,8,20,1,2,8,8,22,21,21,21,11,8,8,8,8,8,22,
21,21,11,8,7,0,3,8,8,22,21,21,21,16,9,9,9,10,8,22,
21,21,11,8,6,5,4,8,8,22,21,21,21,21,21,21,21,11,8,22,
21,21,11,8,8,8,8,15,9,19,21,21,21,21,21,21,21,11,8,22,
21,21,11,8,8,8,8,14,13,13,13,13,13,13,13,13,13,12,8,22,
21,21,11,8,8,8,8,8,8,8,8,8,8,8,8,8,8,8,8,22,
21,21,16,9,9,9,9,9,9,10,8,8,8,8,8,8,8,8,8,22,
21,21,21,21,21,21,21,21,21,16,9,9,9,9,9,9,9,10,8,22,
21,21,21,21,21,21,21,21,21,21,21,21,21,21,21,21,21,11,8,22,
21,21,21,21,21,21,21,21,21,21,21,21,21,21,21,21,21,11,8,22,
21,21,21,21,21,21,21,21,21,21,21,21,21,21,21,21,21,11,8,22,
21,21,21,21,21,21,21,21,21,21,21,21,21,21,21,21,21,11,8,22,
21,21,21,21,21,21,21,21,21,21,21,21,21,21,21,21,21,11,8,22,
21,21,21,21,21,21,21,21,21,21,21,21,21,21,21,21,21,11,8,22,
21,21,17,13,13,13,13,13,13,13,13,13,13,13,13,13,13,12,8,22,
21,21,11,8,8,8,8,8,8,8,8,8,8,8,8,8,8,8,8,22,
21,21,11,8,8,8,8,8,8,15,9,9,9,9,9,9,9,9,9,19,
21,21,11,8,20,1,2,8,8,22,21,21,21,21,21,21,21,21,21,21,
21,21,11,8,7,0,3,8,8,22,21,21,21,21,21,21,21,21,21,21,
21,21,11,8,6,5,4,8,8,22,21,21,21,21,21,21,21,21,21,21,
21,21,11,8,8,8,8,8,8,22,21,21,21,21,21,21,21,21,21,21,
21,21,16,9,9,9,9,9,9,19,21,21,21,21,21,21,21,21,21,21,

layer 1
0,1,1,1,1,1,1,1,1,1,1,0,1,1,1,1,1,1,1,1
0,1,0,0,0,0,0,0,0,0,1,0,1,0,0,0,0,0,0,0
0,1,0,0,0,0,0,0,0,0,1,0,1,0,0,0,0,0,0,0
0,1,0,0,0,0,0,0,0,0,1,0,1,0,0,0,0,0,0,0
0,1,0,0,0,0,0,0,0,0,1,0,1,0,0,0,0,0,0,0
0,1,0,0,0,0,0,0,0,0,1,0,1,1,1,1,1,0,0,0
0,1,0,0,0,0,0,0,0,0,1,1,1,1,1,1,1,0,0,0
0,1,0,0,0,0,0,0,0,0,0,0,0,0,0,0,0,0,0,0
0,1,0,0,0,0,0,0,0,0,0,0,0,0,0,0,0,0,0,0
0,1,0,0,0,0,0,0,0,0,0,0,0,0,0,0,0,0,0,0
0,1,1,1,1,1,1,1,1,0,0,0,0,0,0,0,0,0,0,0
0,0,0,0,0,0,0,0,1,1,1,1,1,1,1,1,1,0,0,0
0,0,0,0,0,0,0,0,0,0,0,0,0,0,0,0,1,0,0,0
0,0,0,0,0,0,0,0,0,0,0,0,0,0,0,0,1,0,0,0
0,0,0,0,0,0,0,0,0,0,0,0,0,0,0,0,1,0,0,0
0,0,0,0,0,0,0,0,0,0,0,0,0,0,0,0,1,0,0,0
0,1,1,1,1,1,1,1,1,1,1,1,1,1,1,1,1,0,0,0
0,1,0,0,0,0,0,0,0,0,0,0,0,0,0,0,0,0,0,0
0,1,0,0,0,0,0,0,0,0,0,0,0,0,0,0,0,0,0,0
0,1,0,0,0,0,0,0,0,0,0,0,0,0,0,0,0,0,0,0
0,1,0,0,0,0,0,0,0,0,1,1,1,1,1,1,1,1,1,1
0,1,0,0,0,0,0,0,0,0,1,0,0,0,0,0,0,0,0,0
0,1,0,0,0,0,0,0,0,0,1,0,0,0,0,0,0,0,0,0
0,1,0,0,0,0,0,0,0,0,1,0,0,0,0,0,0,0,0,0
0,1,0,0,0,0,0,0,0,0,1,0,0,0,0,0,0,0,0,0

