21,21,21,21,21,21,21,21,21,21,21,21,21,21,21,21,21,21,21,21
21,21,17,13,13,13,13,13,13,18,21,21,21,17,13,13,13,13,13,18
21,21,11,08,08,08,08,08,08,22,21,21,21,11,08,08,08,08,08,22
21,21,11,08,20,01,02,08,08,22,21,21,21,11,08,08,08,08,08,22
21,21,11,08,07,00,03,08,08,22,21,21,21,16,09,09,09,10,08,22
21,21,11,08,06,05,04,08,08,22,21,21,21,21,21,21,21,11,08,22
21,21,11,08,08,08,08,15,09,19,21,21,21,21,21,21,21,11,08,22
21,21,11,08,08,08,08,14,13,13,13,13,13,13,13,13,13,12,08,22
21,21,11,08,08,08,08,08,08,08,08,08,08,08,08,08,08,08,08,22
21,21,16,09,09,09,09,09,09,10,08,08,08,08,08,08,08,08,08,22
21,21,21,21,21,21,21,21,21,16,09,09,09,09,09,09,09,10,08,22
21,21,21,21,21,21,21,21,21,21,21,21,21,21,21,21,21,11,08,22
21,21,21,21,21,21,21,21,21,21,21,21,21,21,21,21,21,11,08,22
21,21,21,21,21,21,21,21,21,21,21,21,21,21,21,21,21,11,08,22
21,21,21,21,21,21,21,21,21,21,21,21,21,21,21,21,21,11,08,22
21,21,21,21,21,21,21,21,21,21,21,21,21,21,21,21,21,11,08,22
21,21,21,21,21,21,21,21,21,21,21,21,21,21,21,21,21,11,08,22
21,21,17,13,13,13,13,13,13,13,13,13,13,13,13,13,13,12,08,22
21,21,11,08,08,08,08,08,08,08,08,08,08,08,08,08,08,08,08,22
21,21,11,08,08,08,08,08,08,15,09,09,09,09,09,09,09,09,09,19
21,21,11,08,20,01,02,08,08,22,21,21,21,21,21,21,21,21,21,21
21,21,11,08,07,00,03,08,08,22,21,21,21,21,21,21,21,21,21,21
21,21,11,08,06,05,04,08,08,22,21,21,21,21,21,21,21,21,21,21
21,21,11,08,08,08,08,08,08,22,21,21,21,21,21,21,21,21,21,21
21,21,16,09,09,09,09,09,09,19,21,21,21,21,21,21,21,21,21,21
 
0,1,1,1,1,1,1,1,1,1,1,0,1,1,1,1,1,1,1,1
0,1,0,0,0,0,0,0,0,0,1,0,1,0,0,0,0,0,0,0
0,1,0,0,0,0,0,0,0,0,1,0,1,0,0,0,0,0,0,0
0,1,0,0,0,0,0,0,0,0,1,0,1,0,0,0,0,0,0,0
0,1,0,0,0,0,0,0,0,0,1,0,1,0,0,0,0,0,0,0
0,1,0,0,0,0,0,0,0,0,1,0,1,1,1,1,1,0,0,0
0,1,0,0,0,0,0,0,0,0,1,1,1,1,1,1,1,0,0,0
0,1,0,0,0,0,0,0,0,0,0,0,0,0,0,0,0,0,0,0
0,1,0,0,0,0,0,0,0,0,0,0,0,0,0,0,0,0,0,0
0,1,0,0,0,0,0,0,0,0,0,0,0,0,0,0,0,0,0,0
0,1,1,1,1,1,1,1,1,0,0,0,0,0,0,0,0,0,0,0
0,0,0,0,0,0,0,0,1,1,1,1,1,1,1,1,1,0,0,0
0,0,0,0,0,0,0,0,0,0,0,0,0,0,0,0,1,0,0,0
0,0,0,0,0,0,0,0,0,0,0,0,0,0,0,0,1,0,0,0
0,0,0,0,0,0,0,0,0,0,0,0,0,0,0,0,1,0,0,0
0,0,0,0,0,0,0,0,0,0,0,0,0,0,0,0,1,0,0,0
0,1,1,1,1,1,1,1,1,1,1,1,1,1,1,1,1,0,0,0
0,1,0,0,0,0,0,0,0,0,0,0,0,0,0,0,0,0,0,0
0,1,0,0,0,0,0,0,0,0,0,0,0,0,0,0,0,0,0,0
0,1,0,0,0,0,0,0,0,0,0,0,0,0,0,0,0,0,0,0
0,1,0,0,0,0,0,0,0,0,1,1,1,1,1,1,1,1,1,1
0,1,0,0,0,0,0,0,0,0,1,0,0,0,0,0,0,0,0,0
0,1,0,0,0,0,0,0,0,0,1,0,0,0,0,0,0,0,0,0
0,1,0,0,0,0,0,0,0,0,1,0,0,0,0,0,0,0,0,0
0,1,0,0,0,0,0,0,0,0,1,0,0,0,0,0,0,0,0,0