00,00,00,00,00,00,00,00,00,00
00,06,07,04,07,04,07,04,09,00
00,10,00,12,11,00,12,11,10,00
00,10,00,15,13,00,16,14,10,00
00,05,07,04,07,04,07,04,08,00
00,01,01,01,01,01,01,01,01,00
00,01,01,01,01,01,01,01,01,03
00,01,01,01,01,01,01,01,01,02
00,01,01,01,01,01,01,01,01,00
00,00,00,00,00,00,00,00,00,00

1,1,1,1,1,1,1,1,1,1
1,0,0,0,0,0,0,0,0,1
1,0,1,1,1,1,1,1,0,1
1,0,1,1,1,1,1,1,0,1
1,0,0,0,0,0,0,0,0,1
1,0,0,0,0,0,0,0,0,1
1,0,0,0,0,0,0,0,0,0
1,0,0,0,0,0,0,0,0,0
1,0,0,0,0,0,0,0,0,1
1,1,1,1,1,1,1,1,1,1

